NO ./assets/textures/floor.xpm
SO ./assets/textures/floor.xpm
WE ./assets/textures/floor.xpm
EA ./assets/textures/floor.xpm

C 225,30,0
F 220,100,0

111111
10010111
101001
11000E
111111
