NO ./assets/textures/floor.xpm
SO ./assets/textures/floor.xpm
WE ./assets/textures/floor.xpm
EA ./assets/textures/floor.xpm

C 225,30,0
F 220,100,0

011111
1001011
101 01
1100N1
111111
