NO ./assets/textures/floor.xpm
SO ./assets/textures/floor.xpm
WE ./assets/textures/floor.xpm
EA ./assets/textures/floor.xpm

F 220,100,0

111111
100101
101001
1100N1
111111
C 225,30,0
